20 20 4
####################
#                  #
#                  #
#                  #
#                  #
#                  #
#                  #
#                  #
####################
#        *         #
####################
#                  #
#                  #
#                  #
#                  #
#                  #
#                  #
#                  #
#                  #
####################